Id,Season,HomeTeam,HomePoints,AwayTeam,AwayPoints,PointDiff
401014972,2018,Rice,31,Prairie View A&M,28,3
401021651,2018,Georgia State,24,Kennesaw State,20,4
401013086,2018,Tulane,17,Wake Forest,23,6
401013342,2018,Purdue,27,Northwestern,31,4
401021655,2018,UL Monroe,34,SE Louisiana,31,3
401022511,2018,San José State,38,UC Davis,44,6
401012880,2018,Michigan State,38,Utah State,31,7
401012872,2018,Maryland,34,Texas,29,5
401019473,2018,Temple,17,Villanova,19,2
401012804,2018,Illinois,31,Kent State,24,7
401020675,2018,Ohio,38,Howard,32,6
401013349,2018,Penn State,45,App State,38,7
401012248,2018,Auburn,21,Washington,16,5
401012684,2018,California,24,North Carolina,17,7
401014975,2018,Miami (OH),28,Marshall,35,7
401013048,2018,Kansas,23,Nicholls,26,3
401013057,2018,Kansas State,27,South Dakota,24,3
401014974,2018,South Alabama,26,Louisiana Tech,30,4
401012888,2018,Notre Dame,24,Michigan,17,7
401012676,2018,Arizona,23,BYU,28,5
401079833,2018,East Carolina,23,North Carolina A&T,28,5
401013352,2018,Purdue,19,Eastern Michigan,20,1
401014983,2018,Florida Atlantic,33,Air Force,26,7
401019479,2018,Navy,22,Memphis,21,1
401013377,2018,Notre Dame,24,Ball State,16,8
401012729,2018,Nebraska,28,Colorado,33,5
401019478,2018,Temple,29,Buffalo,36,7
401012270,2018,Texas A&M,26,Clemson,28,2
401014989,2018,Southern Miss,20,UL Monroe,21,1
401013329,2018,Minnesota,21,Fresno State,14,7
401014992,2018,Western Kentucky,28,Maine,31,3
401012852,2018,Indiana,20,Virginia,16,4
401014982,2018,Old Dominion,20,Florida International,28,8
401012261,2018,Colorado State,34,Arkansas,27,7
401013319,2018,Texas,28,Tulsa,21,7
401012735,2018,BYU,18,California,21,3
401012727,2018,Arizona State,16,Michigan State,13,3
401014993,2018,Charlotte,28,Old Dominion,25,3
401013109,2018,Wake Forest,34,Boston College,41,7
401019486,2018,UConn,56,Rhode Island,49,7
401013337,2018,Nebraska,19,Troy,24,5
401013368,2018,Army,28,Hawai'i,21,7
401013112,2018,Pittsburgh,24,Georgia Tech,19,5
401014996,2018,UAB,31,Tulane,24,7
401012283,2018,Notre Dame,22,Vanderbilt,17,5
401012806,2018,Illinois,19,South Florida,25,6
401020679,2018,Northern Illinois,24,Central Michigan,16,8
401012273,2018,Auburn,21,LSU,22,1
401013356,2018,Wisconsin,21,BYU,24,3
401020681,2018,Bowling Green,42,Eastern Kentucky,35,7
401022520,2018,Wyoming,17,Wofford,14,3
401020682,2018,Buffalo,35,Eastern Michigan,28,7
401012744,2018,Nevada,37,Oregon State,35,2
401012279,2018,Purdue,37,Missouri,40,3
401013343,2018,Northwestern,34,Akron,39,5
401013113,2018,Louisville,20,Western Kentucky,17,3
401012738,2018,San Diego State,28,Arizona State,21,7
401012748,2018,USC,39,Washington State,36,3
401019491,2018,Cincinnati,34,Ohio,30,4
401019495,2018,SMU,31,Navy,30,1
401013125,2018,North Carolina,38,Pittsburgh,35,3
401015000,2018,Ball State,20,Western Kentucky,28,8
401014999,2018,UTSA,25,Texas State,21,4
401021664,2018,UL Monroe,27,Troy,35,8
401021663,2018,Louisiana,28,Coastal Carolina,30,2
401013066,2018,Oklahoma,28,Army,21,7
401021662,2018,Arkansas State,27,UNLV,20,7
401013440,2018,UTEP,20,New Mexico State,27,7
401019492,2018,South Florida,20,East Carolina,13,7
401012749,2018,Oregon,31,Stanford,38,7
401012751,2018,Washington,27,Arizona State,20,7
401020683,2018,San Diego State,23,Eastern Michigan,20,3
401013131,2018,Clemson,27,Syracuse,23,4
401013325,2018,Texas Tech,34,West Virginia,42,8
401012824,2018,Rutgers,17,Indiana,24,7
401012293,2018,Texas A&M,24,Arkansas,17,7
401020750,2018,Miami (OH),39,Western Michigan,40,1
401013060,2018,Kansas State,14,Texas,19,5
401015006,2018,East Carolina,37,Old Dominion,35,2
401013133,2018,Louisville,24,Florida State,28,4
401022525,2018,Air Force,25,Nevada,28,3
401012299,2018,Vanderbilt,31,Tennessee State,27,4
401012892,2018,Northwestern,17,Michigan,20,3
401012298,2018,Mississippi State,6,Florida,13,7
401021666,2018,Georgia Southern,28,Arkansas State,21,7
401020688,2018,Eastern Michigan,23,Northern Illinois,26,3
401012756,2018,Washington State,28,Utah,24,4
401022527,2018,San José State,41,Hawai'i,44,3
401015003,2018,Middle Tennessee,25,Florida Atlantic,24,1
401013041,2018,TCU,17,Iowa State,14,3
401013347,2018,Penn State,26,Ohio State,27,1
401015005,2018,Western Kentucky,17,Marshall,20,3
401015004,2018,North Texas,27,Louisiana Tech,29,2
401012753,2018,Arizona,20,USC,24,4
401013067,2018,Oklahoma,45,Texas,48,3
401012305,2018,South Carolina,37,Missouri,35,2
401020753,2018,Western Michigan,27,Eastern Michigan,24,3
401013142,2018,Pittsburgh,44,Syracuse,37,7
401013139,2018,NC State,28,Boston College,23,5
401020754,2018,Ball State,16,Northern Illinois,24,8
401013031,2018,Baylor,37,Kansas State,34,3
401012301,2018,Florida,27,LSU,19,8
401020755,2018,Kent State,26,Ohio,27,1
401022528,2018,Boise State,13,San Diego State,19,6
401013042,2018,Oklahoma State,42,Iowa State,48,6
401013141,2018,Miami,28,Florida State,27,1
401012761,2018,Colorado,28,Arizona State,21,7
401012306,2018,Texas A&M,20,Kentucky,14,6
401015011,2018,UTEP,24,North Texas,27,3
401012760,2018,UCLA,24,Washington,31,7
401013441,2018,New Mexico State,49,Liberty,41,8
401012759,2018,Arizona,24,California,17,7
401022531,2018,Hawai'i,17,Wyoming,13,4
401021673,2018,Texas State,13,Georgia Southern,15,2
401013076,2018,TCU,14,Texas Tech,17,3
401019505,2018,Tulsa,24,South Florida,25,1
401022533,2018,San Diego State,21,Air Force,17,4
401012309,2018,Auburn,24,Tennessee,30,6
401013340,2018,Northwestern,34,Nebraska,31,3
401020759,2018,Eastern Michigan,28,Toledo,26,2
401013452,2018,Liberty,22,Troy,16,6
401013148,2018,Notre Dame,19,Pittsburgh,14,5
401020760,2018,Bowling Green,35,Western Michigan,42,7
401020757,2018,Central Michigan,23,Ball State,24,1
401019506,2018,Memphis,30,UCF,31,1
401019508,2018,Navy,17,Temple,24,7
401020758,2018,Northern Illinois,24,Ohio,21,3
401012311,2018,South Carolina,23,Texas A&M,26,3
401013032,2018,Texas,23,Baylor,17,6
401012883,2018,Penn State,17,Michigan State,21,4
401012766,2018,Oregon,30,Washington,27,3
401022535,2018,Colorado State,20,New Mexico,18,2
401013147,2018,North Carolina,19,Virginia Tech,22,3
401013146,2018,Virginia,16,Miami,13,3
401015014,2018,Florida International,24,Middle Tennessee,21,3
401012308,2018,Arkansas,33,Ole Miss,37,4
401022534,2018,Nevada,27,Boise State,31,4
401012768,2018,Arizona State,13,Stanford,20,7
401022539,2018,UNLV,35,Air Force,41,6
401013371,2018,Army,31,Miami (OH),30,1
401012846,2018,Rutgers,15,Northwestern,18,3
401019510,2018,Temple,24,Cincinnati,17,7
401013152,2018,Syracuse,40,North Carolina,37,3
401013453,2018,Liberty,48,Idaho State,41,7
401022540,2018,Wyoming,16,Utah State,24,8
401015019,2018,Middle Tennessee,21,Charlotte,13,8
401020761,2018,Kent State,23,Akron,24,1
401012857,2018,Indiana,28,Penn State,33,5
401015022,2018,Louisiana Tech,31,UTEP,24,7
401019513,2018,Tulane,23,SMU,27,4
401019511,2018,South Florida,38,UConn,30,8
401021678,2018,UL Monroe,20,Texas State,14,6
401015023,2018,UAB,29,North Texas,21,8
401015024,2018,Western Kentucky,34,Old Dominion,37,3
401012314,2018,Kentucky,14,Vanderbilt,7,7
401012769,2018,UCLA,31,Arizona,30,1
401022543,2018,San Diego State,16,San José State,13,3
401015028,2018,Florida Atlantic,13,Louisiana Tech,21,8
401012858,2018,Minnesota,38,Indiana,31,7
401020768,2018,Akron,17,Central Michigan,10,7
401013364,2018,UConn,17,Massachusetts,22,5
401021682,2018,Georgia State,34,Coastal Carolina,37,3
401015026,2018,Charlotte,20,Southern Miss,17,3
401013053,2018,Kansas,27,TCU,26,1
401012777,2018,Colorado,34,Oregon State,41,7
401016409,2018,BYU,6,Northern Illinois,7,1
401012868,2018,Penn State,30,Iowa,24,6
401012776,2018,USC,35,Arizona State,38,3
401019514,2018,SMU,20,Cincinnati,26,6
401012322,2018,Missouri,14,Kentucky,15,1
401012778,2018,California,12,Washington,10,2
401013444,2018,Texas State,27,New Mexico State,20,7
401021681,2018,Louisiana,47,Arkansas State,43,4
401019516,2018,Tulsa,17,Tulane,24,7
401012779,2018,Stanford,38,Washington State,41,3
401012323,2018,South Carolina,27,Tennessee,24,3
401013320,2018,Oklahoma State,38,Texas,35,3
401022548,2018,Nevada,28,San Diego State,24,4
401020769,2018,Bowling Green,28,Kent State,35,7
401012780,2018,Arizona,42,Colorado,34,8
401013373,2018,Army,17,Air Force,14,3
401012328,2018,Ole Miss,44,South Carolina,48,4
401012324,2018,Auburn,28,Texas A&M,24,4
401013341,2018,Ohio State,36,Nebraska,31,5
401013034,2018,Baylor,35,Oklahoma State,31,4
401015033,2018,Southern Miss,26,Marshall,24,2
401013188,2018,Texas,41,West Virginia,42,1
401012869,2018,Purdue,38,Iowa,36,2
401013063,2018,TCU,14,Kansas State,13,1
401013365,2018,Massachusetts,62,Liberty,59,3
401015035,2018,Rice,26,UTEP,34,8
401013163,2018,Miami,12,Duke,20,8
401013069,2018,Texas Tech,46,Oklahoma,51,5
401012784,2018,Washington,27,Stanford,23,4
401022550,2018,New Mexico,23,San Diego State,31,8
401016410,2018,Boise State,21,BYU,16,5
401012785,2018,Washington State,19,California,13,6
401020776,2018,Miami (OH),30,Ohio,28,2
401013167,2018,NC State,23,Wake Forest,27,4
401022556,2018,Boise State,24,Fresno State,17,7
401013054,2018,Kansas State,21,Kansas,17,4
401012859,2018,Indiana,34,Maryland,32,2
401012335,2018,Missouri,33,Vanderbilt,28,5
401012333,2018,Florida,35,South Carolina,31,4
401013170,2018,Duke,42,North Carolina,35,7
401012786,2018,Arizona State,31,UCLA,28,3
401013070,2018,Oklahoma,48,Oklahoma State,47,1
401015042,2018,Old Dominion,34,North Texas,31,3
401012870,2018,Iowa,10,Northwestern,14,4
401019526,2018,Tulane,24,East Carolina,18,6
401012789,2018,Utah,32,Oregon,25,7
401013172,2018,Georgia Tech,27,Miami,21,6
401012332,2018,Arkansas,17,LSU,24,7
401013321,2018,Texas Tech,34,Texas,41,7
401015043,2018,UAB,26,Southern Miss,23,3
401012787,2018,USC,14,California,15,1
401022558,2018,San Diego State,24,UNLV,27,3
401020780,2018,Ball State,42,Western Michigan,41,1
401020782,2018,Northern Illinois,7,Miami (OH),13,6
401015045,2018,North Texas,41,Florida Atlantic,38,3
401012887,2018,Nebraska,9,Michigan State,6,3
401013036,2018,Baylor,9,TCU,16,7
401012878,2018,Maryland,51,Ohio State,52,1
401015044,2018,Charlotte,35,Florida International,42,7
401022561,2018,Colorado State,24,Utah State,29,5
401012791,2018,UCLA,34,USC,27,7
401013177,2018,Georgia Tech,30,Virginia,27,3
401013353,2018,Purdue,44,Wisconsin,47,3
401015046,2018,Southern Miss,21,Louisiana Tech,20,1
401019534,2018,Navy,37,Tulsa,29,8
401013175,2018,Florida State,22,Boston College,21,1
401021696,2018,Troy,12,Texas State,7,5
401013327,2018,Oklahoma State,45,West Virginia,41,4
401022559,2018,Wyoming,35,Air Force,27,8
401012348,2018,Vanderbilt,36,Ole Miss,29,7
401012793,2018,Oregon,31,Arizona State,29,2
401022564,2018,Hawai'i,35,UNLV,28,7
401020786,2018,Western Michigan,28,Northern Illinois,21,7
401022565,2018,Air Force,27,Colorado State,19,8
401012871,2018,Iowa,31,Nebraska,28,3
401020790,2018,Kent State,20,Eastern Michigan,28,8
401013056,2018,Kansas,17,Texas,24,7
401021699,2018,South Alabama,31,Coastal Carolina,28,3
401013183,2018,Virginia Tech,34,Virginia,31,3
401013071,2018,West Virginia,56,Oklahoma,59,3
401012861,2018,Indiana,21,Purdue,28,7
401015051,2018,Florida International,25,Marshall,28,3
401019539,2018,Tulane,29,Navy,28,1
401013187,2018,North Carolina,28,NC State,34,6
401013447,2018,Liberty,28,New Mexico State,21,7
401021701,2018,UL Monroe,28,Louisiana,31,3
401012801,2018,UCLA,42,Stanford,49,7
401012815,2018,Northwestern,24,Illinois,16,8
401019540,2018,Tulsa,27,SMU,24,3
401012799,2018,Arizona,40,Arizona State,41,1
401012850,2018,Michigan State,14,Rutgers,10,4
401015050,2018,Florida Atlantic,24,Charlotte,27,3
401013047,2018,Iowa State,42,Kansas State,38,4
401015054,2018,UTSA,21,North Texas,24,3
401012356,2018,Texas A&M,74,LSU,72,2
401012800,2018,USC,17,Notre Dame,24,7
401013078,2018,TCU,31,Oklahoma State,24,7
401022569,2018,UNLV,34,Nevada,29,5
401012802,2018,Utah,35,BYU,27,8
401022568,2018,San Diego State,30,Hawai'i,31,1
401056696,2018,Buffalo,29,Northern Illinois,30,1
401056704,2018,Washington,10,Utah,3,7
401082044,2018,Iowa State,27,Drake,24,3
401056703,2018,Middle Tennessee,25,UAB,27,2
401056705,2018,Georgia,28,Alabama,35,7
401056700,2018,Boise State,16,Fresno State,19,3
401013376,2018,Army,17,Navy,10,7
401032056,2018,Eastern Michigan,21,Georgia Southern,23,2
401032061,2018,Toledo,32,Florida International,35,3
401032063,2018,Wake Forest,37,Memphis,34,3
401032069,2018,TCU,10,California,7,3
401032072,2018,Vanderbilt,38,Baylor,45,7
401032075,2018,Washington State,28,Iowa State,26,2
401035252,2018,Nevada,16,Arkansas State,13,3
401032080,2018,Virginia Tech,31,Cincinnati,35,4
401035251,2018,Pittsburgh,13,Stanford,14,1
401035254,2018,Oregon,7,Michigan State,6,1
401032081,2018,Oklahoma State,38,Missouri,33,5
401032083,2018,Iowa,27,Mississippi State,22,5
401032084,2018,UCF,32,LSU,40,8
401032088,2018,Penn State,24,Kentucky,27,3
401032085,2018,Ohio State,28,Washington,23,5
401032086,2018,Georgia,21,Texas,28,7
401110723,2019,Florida,24,Miami,20,4
401114164,2019,Hawai'i,45,Arizona,38,7
401117855,2019,UConn,24,Wagner,21,3
401114246,2019,Western Kentucky,28,Central Arkansas,35,7
401114237,2019,UAB,24,Alabama State,19,5
401112229,2019,Minnesota,28,South Dakota State,21,7
401114238,2019,Army,14,Rice,7,7
401112430,2019,Wake Forest,38,Utah State,35,3
401112262,2019,Nevada,34,Purdue,31,3
401110726,2019,Memphis,15,Ole Miss,10,5
401112096,2019,Kansas,24,Indiana State,17,7
401112431,2019,Florida State,31,Boise State,36,5
401112085,2019,Iowa State,29,Northern Iowa,26,3
401112143,2019,West Virginia,20,James Madison,13,7
401119256,2019,Coastal Carolina,23,Eastern Michigan,30,7
401110730,2019,Tennessee,30,Georgia State,38,8
401110729,2019,North Carolina,24,South Carolina,20,4
401112435,2019,Boston College,35,Virginia Tech,28,7
401110721,2019,Arkansas,20,Portland State,13,7
401117495,2019,New Mexico,39,Sam Houston,31,8
401117858,2019,Arkansas State,30,SMU,37,7
401114242,2019,Old Dominion,24,Norfolk State,21,3
401110722,2019,Auburn,27,Oregon,21,6
401110728,2019,Wyoming,37,Missouri,31,6
401114244,2019,UTEP,36,Houston Christian,34,2
401117496,2019,San Diego State,6,Weber State,0,6
401114218,2019,USC,31,Fresno State,23,8
401114251,2019,Boise State,14,Marshall,7,7
401112223,2019,Michigan,24,Army,21,3
401119261,2019,Kent State,26,Kennesaw State,23,3
401112441,2019,Georgia Tech,14,South Florida,10,4
401114250,2019,Louisiana Tech,20,Grambling,14,6
401112239,2019,Colorado,34,Nebraska,31,3
401112146,2019,UConn,23,Illinois,31,8
401112440,2019,Florida State,45,UL Monroe,44,1
401121936,2019,Georgia Southern,26,Maine,18,8
401121937,2019,Georgia State,48,Furman,42,6
401114248,2019,Florida International,14,Western Kentucky,20,6
401112097,2019,Kansas,7,Coastal Carolina,12,5
401110783,2019,Tennessee,26,BYU,29,3
401110778,2019,Texas,38,LSU,45,7
401112443,2019,North Carolina,28,Miami,25,3
401114175,2019,Washington,19,California,20,1
401112230,2019,Fresno State,35,Minnesota,38,3
401114200,2019,Hawai'i,31,Oregon State,28,3
401112448,2019,Wake Forest,24,North Carolina,18,6
401114230,2019,Houston,24,Washington State,31,7
401112455,2019,Virginia Tech,24,Furman,17,7
401112203,2019,Temple,20,Maryland,17,3
401110792,2019,Mississippi State,24,Kansas State,31,7
401112259,2019,Penn State,17,Pittsburgh,10,7
401112147,2019,Illinois,31,Eastern Michigan,34,3
401112452,2019,Georgia Tech,24,The Citadel,27,3
401114185,2019,Colorado,23,Air Force,30,7
401112231,2019,Minnesota,35,Georgia Southern,32,3
401114219,2019,BYU,30,USC,27,3
401112086,2019,Iowa State,17,Iowa,18,1
401112214,2019,Michigan State,7,Arizona State,10,3
401114176,2019,California,23,North Texas,17,6
401117504,2019,Wyoming,21,Idaho,16,5
401114260,2019,Troy,42,Southern Miss,47,5
401114259,2019,Marshall,33,Ohio,31,2
401117505,2019,Nevada,19,Weber State,13,6
401110789,2019,Kentucky,21,Florida,29,8
401112451,2019,Virginia,31,Florida State,24,7
401117869,2019,Tulane,38,Houston,31,7
401114220,2019,USC,30,Utah,23,7
401110801,2019,Ole Miss,20,California,28,8
401119267,2019,Eastern Michigan,34,Central Connecticut,29,5
401117509,2019,Tulsa,24,Wyoming,21,3
401112131,2019,TCU,38,SMU,41,3
401112461,2019,Pittsburgh,35,UCF,34,1
401112459,2019,North Carolina,31,App State,34,3
401110804,2019,Texas A&M,20,Auburn,28,8
401112458,2019,Miami,17,Central Michigan,12,5
401112099,2019,Kansas,24,West Virginia,29,5
401114340,2019,New Mexico,55,New Mexico State,52,3
401121942,2019,Texas State,37,Georgia State,34,3
401112075,2019,Rice,13,Baylor,21,8
401110798,2019,Arkansas,24,San José State,31,7
401112125,2019,Texas,36,Oklahoma State,30,6
401112148,2019,Illinois,38,Nebraska,42,4
401110800,2019,Georgia,23,Notre Dame,17,6
401114155,2019,Arizona State,31,Colorado,34,3
401117507,2019,Colorado State,35,Toledo,41,6
401117508,2019,San Diego State,17,Utah State,23,6
401114215,2019,Washington State,63,UCLA,67,4
401114156,2019,California,17,Arizona State,24,7
401110807,2019,Arkansas,27,Texas A&M,31,4
401110811,2019,Vanderbilt,24,Northern Illinois,18,6
401117213,2019,Toledo,28,BYU,21,7
401112470,2019,Pittsburgh,17,Delaware,14,3
401112466,2019,Boston College,24,Wake Forest,27,3
401112076,2019,Baylor,23,Iowa State,21,2
401112232,2019,Purdue,31,Minnesota,38,7
401112467,2019,North Carolina,20,Clemson,21,1
401114356,2019,Massachusetts,37,Akron,29,8
401121944,2019,Troy,43,Arkansas State,50,7
401114350,2019,Liberty,17,New Mexico,10,7
401114271,2019,Old Dominion,21,East Carolina,24,3
401114273,2019,Western Kentucky,20,UAB,13,7
401114268,2019,Rice,20,Louisiana Tech,23,3
401114202,2019,Oregon State,28,Stanford,31,3
401114166,2019,Arizona,20,UCLA,17,3
401121948,2019,South Alabama,17,Georgia Southern,20,3
401117875,2019,Cincinnati,27,UCF,24,3
401112194,2019,Michigan,10,Iowa,3,7
401112473,2019,Louisville,41,Boston College,39,2
401119275,2019,Toledo,31,Western Michigan,24,7
401119274,2019,Buffalo,20,Ohio,21,1
401119272,2019,Northern Illinois,20,Ball State,27,7
401112476,2019,Miami,35,Virginia Tech,42,7
401112242,2019,Nebraska,13,Northwestern,10,3
401114167,2019,Colorado,30,Arizona,35,5
401117878,2019,SMU,43,Tulsa,37,6
401112474,2019,Duke,30,Pittsburgh,33,3
401114342,2019,New Mexico State,13,Liberty,20,7
401112477,2019,NC State,16,Syracuse,10,6
401112478,2019,Miami,17,Virginia,9,8
401117881,2019,Temple,30,Memphis,28,2
401110817,2019,Georgia,17,South Carolina,20,3
401112118,2019,Texas,27,Oklahoma,34,7
401119276,2019,Eastern Michigan,23,Ball State,29,6
401117214,2019,South Florida,27,BYU,23,4
401114157,2019,Arizona State,38,Washington State,34,4
401119279,2019,Ohio,36,Northern Illinois,39,3
401117524,2019,Nevada,41,San José State,38,3
401112078,2019,Baylor,33,Texas Tech,30,3
401112481,2019,Wake Forest,59,Louisville,62,3
401110818,2019,Kentucky,24,Arkansas,20,4
401114222,2019,Notre Dame,30,USC,27,3
401112195,2019,Iowa,12,Penn State,17,5
401117523,2019,San Diego State,26,Wyoming,22,4
401114288,2019,Florida Atlantic,31,Marshall,36,5
401112483,2019,Syracuse,20,Pittsburgh,27,7
401119283,2019,Ohio,45,Kent State,38,7
401117886,2019,UConn,17,Houston,24,7
401112151,2019,Illinois,24,Wisconsin,23,1
401112488,2019,Miami,21,Georgia Tech,28,7
401112196,2019,Iowa,26,Purdue,20,6
401112109,2019,Kansas State,24,TCU,17,7
401114178,2019,California,17,Oregon State,21,4
401119284,2019,Miami (OH),27,Northern Illinois,24,3
401121956,2019,Georgia Southern,30,Coastal Carolina,27,3
401112489,2019,Virginia Tech,43,North Carolina,41,2
401112163,2019,Maryland,28,Indiana,34,6
401114196,2019,Washington,31,Oregon,35,4
401110830,2019,Vanderbilt,21,Missouri,14,7
401114290,2019,North Texas,33,Middle Tennessee,30,3
401114292,2019,UTSA,31,Rice,27,4
401114329,2019,Georgia State,28,Army,21,7
401119286,2019,Eastern Michigan,34,Western Michigan,27,7
401112102,2019,Texas,50,Kansas,48,2
401112226,2019,Penn State,28,Michigan,21,7
401112487,2019,Wake Forest,22,Florida State,20,2
401110827,2019,Ole Miss,17,Texas A&M,24,7
401117215,2019,BYU,28,Boise State,25,3
401117889,2019,Houston,31,SMU,34,3
401114188,2019,Colorado,31,USC,35,4
401112110,2019,Kansas State,48,Oklahoma,41,7
401114330,2019,Army,29,San José State,34,5
401112494,2019,Pittsburgh,12,Miami,16,4
401114297,2019,Marshall,26,Western Kentucky,23,3
401112493,2019,Louisville,28,Virginia,21,7
401112091,2019,Iowa State,27,Oklahoma State,34,7
401114293,2019,Charlotte,39,North Texas,38,1
401112164,2019,Nebraska,31,Indiana,38,7
401119290,2019,Toledo,37,Eastern Michigan,34,3
401119291,2019,Kent State,16,Miami (OH),23,7
401110833,2019,LSU,23,Auburn,20,3
401117890,2019,Navy,41,Tulane,38,3
401112491,2019,North Carolina,20,Duke,17,3
401117893,2019,Tulsa,41,Memphis,42,1
401112103,2019,Kansas,37,Texas Tech,34,3
401117534,2019,UNLV,17,San Diego State,20,3
401114197,2019,Oregon,37,Washington State,35,2
401121960,2019,App State,21,Georgia Southern,24,3
401112080,2019,Baylor,17,West Virginia,14,3
401112243,2019,Purdue,31,Nebraska,27,4
401114300,2019,Florida International,24,Old Dominion,17,7
401112501,2019,Notre Dame,21,Virginia Tech,20,1
401121962,2019,Coastal Carolina,36,Troy,35,1
401114331,2019,Air Force,17,Army,13,4
401110838,2019,Florida,17,Georgia,24,7
401112127,2019,Oklahoma State,34,TCU,27,7
401121961,2019,UL Monroe,41,Arkansas State,48,7
401114227,2019,Washington,28,Utah,33,5
401110837,2019,Auburn,20,Ole Miss,14,6
401117896,2019,East Carolina,43,Cincinnati,46,3
401117897,2019,Memphis,54,SMU,48,6
401112499,2019,North Carolina,31,Virginia,38,7
401117537,2019,Hawai'i,38,Fresno State,41,3
401119297,2019,Toledo,35,Kent State,33,2
401119296,2019,Western Michigan,35,Ball State,31,4
401119298,2019,Ohio,21,Miami (OH),24,3
401117900,2019,Tulsa,34,UCF,31,3
401112502,2019,Boston College,31,Florida State,38,7
401112081,2019,TCU,23,Baylor,29,6
401112235,2019,Minnesota,31,Penn State,26,5
401117902,2019,SMU,59,East Carolina,51,8
401112249,2019,Northwestern,22,Purdue,24,2
401112504,2019,Virginia,33,Georgia Tech,28,5
401114307,2019,Old Dominion,23,UTSA,24,1
401121967,2019,Texas State,30,South Alabama,28,2
401114190,2019,Colorado,16,Stanford,13,3
401114304,2019,UTEP,21,Charlotte,28,7
401110842,2019,Alabama,41,LSU,46,5
401112154,2019,Michigan State,34,Illinois,37,3
401112111,2019,Texas,27,Kansas State,24,3
401114160,2019,Arizona State,26,USC,31,5
401112198,2019,Wisconsin,24,Iowa,22,2
401110848,2019,South Carolina,15,App State,20,5
401117540,2019,Fresno State,35,Utah State,37,2
401114353,2019,BYU,31,Liberty,24,7
401110846,2019,Kentucky,13,Tennessee,17,4
401112092,2019,Oklahoma,42,Iowa State,41,1
401117541,2019,Boise State,20,Wyoming,17,3
401117542,2019,San Diego State,13,Nevada,17,4
401117543,2019,Hawai'i,42,San José State,40,2
401119300,2019,Ohio,34,Western Michigan,37,3
401119302,2019,Toledo,28,Northern Illinois,31,3
401119303,2019,Kent State,30,Buffalo,27,3
401112507,2019,Pittsburgh,34,North Carolina,27,7
401117905,2019,Temple,29,Tulane,21,8
401112133,2019,Texas Tech,31,TCU,33,2
401112166,2019,Penn State,34,Indiana,27,7
401121969,2019,Arkansas State,28,Coastal Carolina,27,1
401119304,2019,Ball State,44,Central Michigan,45,1
401112093,2019,Iowa State,23,Texas,21,2
401112112,2019,Kansas State,20,West Virginia,24,4
401110849,2019,Auburn,14,Georgia,21,7
401117546,2019,Utah State,26,Wyoming,21,5
401112199,2019,Iowa,23,Minnesota,19,4
401114310,2019,Middle Tennessee,28,Rice,31,3
401117903,2019,South Florida,17,Cincinnati,20,3
401114161,2019,Oregon State,35,Arizona State,34,1
401112082,2019,Baylor,31,Oklahoma,34,3
401119307,2019,Miami (OH),20,Akron,17,3
401112513,2019,Georgia Tech,28,NC State,26,2
401117908,2019,UConn,24,East Carolina,31,7
401117906,2019,Tulane,31,UCF,34,3
401119309,2019,Kent State,41,Ball State,38,3
401112128,2019,West Virginia,13,Oklahoma State,20,7
401121974,2019,Arkansas State,38,Georgia Southern,33,5
401114315,2019,UAB,20,Louisiana Tech,14,6
401114317,2019,Rice,20,North Texas,14,6
401117911,2019,Navy,35,SMU,28,7
401110857,2019,Georgia,19,Texas A&M,13,6
401114182,2019,Stanford,20,California,24,4
401117553,2019,UNLV,38,San José State,35,3
401121975,2019,UL Monroe,45,Coastal Carolina,42,3
401112113,2019,Texas Tech,27,Kansas State,30,3
401117907,2019,Cincinnati,15,Temple,13,2
401112517,2019,Florida International,30,Miami,24,6
401110861,2019,Missouri,20,Tennessee,24,4
401114162,2019,Arizona State,31,Oregon,28,3
401112120,2019,Oklahoma,28,TCU,24,4
401114206,2019,Washington State,54,Oregon State,53,1
401114191,2019,Colorado,20,Washington,14,6
401117551,2019,Fresno State,28,Nevada,35,7
401117552,2019,Hawai'i,14,San Diego State,11,3
401119311,2019,Northern Illinois,17,Western Michigan,14,3
401110863,2019,Mississippi State,21,Ole Miss,20,1
401119313,2019,Eastern Michigan,26,Kent State,34,8
401112200,2019,Nebraska,24,Iowa,27,3
401117554,2019,Colorado State,24,Boise State,31,7
401112134,2019,TCU,17,West Virginia,20,3
401121979,2019,South Alabama,34,Arkansas State,30,4
401121980,2019,Coastal Carolina,24,Texas State,21,3
401112168,2019,Purdue,41,Indiana,44,3
401114321,2019,Marshall,30,Florida International,27,3
401114324,2019,Western Kentucky,31,Middle Tennessee,26,5
401117558,2019,Nevada,30,UNLV,33,3
401110865,2019,Auburn,48,Alabama,45,3
401112221,2019,Michigan State,19,Maryland,16,3
401112522,2019,Pittsburgh,19,Boston College,26,7
401114325,2019,North Texas,21,UAB,26,5
401121982,2019,Louisiana,31,UL Monroe,30,1
401117557,2019,San José State,17,Fresno State,16,1
401132974,2019,Oklahoma,30,Baylor,23,7
401132982,2019,Central Michigan,21,Miami (OH),26,5
401132984,2019,App State,45,Louisiana,38,7
401132976,2019,Memphis,29,Cincinnati,24,5
401147693,2019,Georgia Southern,16,Liberty,23,7
401135265,2019,Arkansas State,34,Florida International,26,8
401135269,2019,BYU,34,Hawai'i,38,4
401135271,2019,Eastern Michigan,30,Pittsburgh,34,4
401135273,2019,Wake Forest,21,Michigan State,27,6
401135274,2019,Texas A&M,24,Oklahoma State,21,3
401135279,2019,Ohio State,23,Clemson,29,6
401135280,2019,Western Michigan,20,Western Kentucky,23,3
401135282,2019,Virginia,28,Florida,36,8
401135283,2019,Kentucky,37,Virginia Tech,30,7
401136255,2019,Arizona State,20,Florida State,14,6
401135284,2019,Kansas State,17,Navy,20,3
401135287,2019,Auburn,24,Minnesota,31,7
401135288,2019,Wisconsin,27,Oregon,28,1
401135291,2019,Tennessee,23,Indiana,22,1
401282714,2021,Illinois,30,Nebraska,22,8
401300995,2021,UCF,36,Boise State,31,5
401300994,2021,Tulsa,17,UC Davis,19,2
401310694,2021,UNLV,33,Eastern Washington,35,2
401309937,2021,Virginia Tech,17,North Carolina,10,7
401282052,2021,Charlotte,31,Duke,28,3
401287888,2021,Kansas,17,South Dakota,14,3
401287894,2021,Oklahoma,40,Tulane,35,5
401282815,2021,Wisconsin,10,Penn State,16,6
401309838,2021,Oregon,31,Fresno State,24,7
401282764,2021,Maryland,30,West Virginia,24,6
401281949,2021,Mississippi State,35,Louisiana Tech,34,1
401310697,2021,Wyoming,19,Montana State,16,3
401287887,2021,Iowa State,16,Northern Iowa,10,6
401309600,2021,Georgia Southern,30,Gardner-Webb,25,5
401287890,2021,Oklahoma State,23,Missouri State,16,7
401281946,2021,Clemson,3,Georgia,10,7
401282179,2021,Illinois,30,UTSA,37,7
401282610,2021,Georgia Tech,21,Northern Illinois,22,1
401309839,2021,Washington,7,Montana,13,6
401309841,2021,Arizona,16,BYU,24,8
401309837,2021,California,17,Nevada,22,5
401309840,2021,Washington State,23,Utah State,26,3
401282614,2021,Florida State,38,Notre Dame,41,3
401282193,2021,Army,38,Western Kentucky,35,3
401282809,2021,Ohio State,28,Oregon,35,7
401282790,2021,Minnesota,31,Miami (OH),26,5
401287899,2021,Oklahoma State,28,Tulsa,23,5
401282065,2021,East Carolina,17,South Carolina,20,3
401282066,2021,Tennessee,34,Pittsburgh,41,7
401309547,2021,Northern Illinois,43,Wyoming,50,7
401309753,2021,Ohio,26,Duquesne,28,2
401282705,2021,Notre Dame,32,Toledo,29,3
401287900,2021,TCU,34,California,32,2
401282067,2021,Colorado,7,Texas A&M,10,3
401309546,2021,Bowling Green,19,South Alabama,22,3
401282184,2021,Louisiana Tech,45,SE Louisiana,42,3
401286295,2021,Troy,13,Liberty,21,8
401287897,2021,Kansas State,31,Southern Illinois,23,8
401282620,2021,Miami,25,App State,23,2
401309603,2021,Louisiana,27,Nicholls,24,3
401282182,2021,Florida International,17,Texas State,23,6
401287901,2021,Texas Tech,28,Stephen F. Austin,22,6
401301003,2021,Arkansas State,50,Memphis,55,5
401282061,2021,Kentucky,35,Missouri,28,7
401282617,2021,Florida State,17,Jacksonville State,20,3
401282068,2021,Colorado State,21,Vanderbilt,24,3
401282626,2021,Louisville,42,UCF,35,7
401282715,2021,Illinois,17,Maryland,20,3
401282798,2021,Oklahoma,23,Nebraska,16,7
401282636,2021,West Virginia,27,Virginia Tech,21,6
401282632,2021,Pittsburgh,41,Western Michigan,44,3
401282073,2021,Kentucky,28,Chattanooga,23,5
401309552,2021,Buffalo,25,Coastal Carolina,28,3
401282627,2021,Clemson,14,Georgia Tech,8,6
401282199,2021,Louisiana Tech,37,SMU,39,2
401282071,2021,Florida,29,Alabama,31,2
401282076,2021,Memphis,31,Mississippi State,29,2
401282628,2021,Duke,30,Northwestern,23,7
401282200,2021,Marshall,38,East Carolina,42,4
401309856,2021,San Diego State,33,Utah,31,2
401309609,2021,Texas State,34,Incarnate Word,42,8
401282070,2021,Penn State,28,Auburn,20,8
401310704,2021,Air Force,45,Utah State,49,4
401309608,2021,South Alabama,28,Alcorn State,21,7
401319455,2021,New Mexico State,43,South Carolina State,35,8
401309607,2021,UL Monroe,12,Jackson State,7,5
401287903,2021,Boise State,20,Oklahoma State,21,1
401309853,2021,Arizona,19,Northern Arizona,21,2
401309855,2021,UCLA,37,Fresno State,40,3
401310705,2021,Hawai'i,13,San José State,17,4
401282208,2021,App State,31,Marshall,30,1
401282204,2021,Charlotte,42,Middle Tennessee,39,3
401282637,2021,Syracuse,24,Liberty,21,3
401310707,2021,Fresno State,38,UNLV,30,8
401282792,2021,Minnesota,10,Bowling Green,14,4
401282206,2021,Central Michigan,31,Florida International,27,4
401282086,2021,Boston College,41,Missouri,34,7
401287910,2021,TCU,34,SMU,42,8
401282085,2021,Mississippi State,25,LSU,28,3
401282716,2021,Purdue,13,Illinois,9,4
401282775,2021,Michigan,20,Rutgers,13,7
401282643,2021,NC State,27,Clemson,21,6
401282640,2021,Florida State,23,Louisville,31,8
401286190,2021,UConn,22,Wyoming,24,2
401282213,2021,Memphis,28,UTSA,31,3
401287907,2021,Baylor,31,Iowa State,29,2
401301011,2021,Tulsa,41,Arkansas State,34,7
401282209,2021,Old Dominion,34,Buffalo,35,1
401309610,2021,Georgia Southern,20,Louisiana,28,8
401301007,2021,East Carolina,31,Charleston Southern,28,3
401282784,2021,Michigan State,23,Nebraska,20,3
401282087,2021,South Carolina,10,Kentucky,16,6
401301008,2021,Houston,28,Navy,20,8
401282205,2021,Louisiana Tech,24,North Texas,17,7
401287908,2021,Oklahoma,16,West Virginia,13,3
401282211,2021,Tulane,21,UAB,28,7
401282214,2021,Western Kentucky,31,Indiana,33,2
401282212,2021,UTEP,20,New Mexico,13,7
401309857,2021,Washington,31,California,24,7
401301009,2021,BYU,35,South Florida,27,8
401282646,2021,Miami,28,Virginia,30,2
401282793,2021,Purdue,13,Minnesota,20,7
401301015,2021,Temple,34,Memphis,31,3
401309561,2021,Buffalo,17,Western Michigan,24,7
401287915,2021,TCU,27,Texas,32,5
401282651,2021,Wake Forest,37,Louisville,34,3
401309558,2021,Northern Illinois,27,Eastern Michigan,20,7
401301013,2021,Navy,34,UCF,30,4
401287913,2021,Kansas State,31,Oklahoma,37,6
401309562,2021,Kent State,27,Bowling Green,20,7
401282648,2021,Florida State,33,Syracuse,30,3
401309864,2021,Stanford,31,Oregon,24,7
401287916,2021,West Virginia,20,Texas Tech,23,3
401282222,2021,UTSA,24,UNLV,17,7
401282220,2021,NC State,34,Louisiana Tech,27,7
401282091,2021,Kentucky,20,Florida,13,7
401282218,2021,Rice,24,Southern Miss,19,5
401282216,2021,Middle Tennessee,34,Marshall,28,6
401282095,2021,Texas A&M,22,Mississippi State,26,4
401282096,2021,Vanderbilt,30,UConn,28,2
401282647,2021,Clemson,19,Boston College,13,6
401309615,2021,South Alabama,18,Louisiana,20,2
401309865,2021,Oregon State,27,Washington,24,3
401282092,2021,LSU,19,Auburn,24,5
401282217,2021,UTEP,28,Old Dominion,21,7
401310713,2021,San José State,37,New Mexico State,31,6
401310712,2021,Hawai'i,27,Fresno State,24,3
401282100,2021,Ole Miss,52,Arkansas,51,1
401309564,2021,Toledo,20,Northern Illinois,22,2
401287918,2021,Texas,48,Oklahoma,55,7
401282652,2021,Duke,27,Georgia Tech,31,4
401282226,2021,Marshall,20,Old Dominion,13,7
401282653,2021,Louisville,33,Virginia,34,1
401309567,2021,Ohio,27,Central Michigan,30,3
401282655,2021,Syracuse,37,Wake Forest,40,3
401301021,2021,Navy,24,SMU,31,7
401308836,2021,Eastern Michigan,13,Miami (OH),12,1
401282758,2021,Iowa,23,Penn State,20,3
401309869,2021,Washington State,31,Oregon State,24,7
401301019,2021,UCF,20,East Carolina,16,4
401309619,2021,Texas State,33,South Alabama,31,2
401309617,2021,Troy,27,Georgia Southern,24,3
401282228,2021,Western Kentucky,46,UTSA,52,6
401282778,2021,Nebraska,29,Michigan,32,3
401282656,2021,Virginia Tech,29,Notre Dame,32,3
401282103,2021,Texas A&M,41,Alabama,38,3
401301020,2021,Tulsa,35,Memphis,29,6
401282657,2021,Syracuse,14,Clemson,17,3
401309872,2021,Oregon,24,California,17,7
401310723,2021,San José State,13,San Diego State,19,6
401282106,2021,LSU,49,Florida,42,7
401282731,2021,Indiana,15,Michigan State,20,5
401309571,2021,Buffalo,27,Ohio,26,1
401287924,2021,Texas,24,Oklahoma State,32,8
401286192,2021,UConn,21,Yale,15,6
401301024,2021,South Florida,31,Tulsa,32,1
401282796,2021,Minnesota,30,Nebraska,23,7
401309568,2021,Eastern Michigan,31,Ball State,38,7
401309622,2021,Texas State,28,Troy,31,3
401309570,2021,Northern Illinois,34,Bowling Green,26,8
401309569,2021,Central Michigan,26,Toledo,23,3
401282659,2021,North Carolina,45,Miami,42,3
401282109,2021,South Carolina,21,Vanderbilt,20,1
401286296,2021,UL Monroe,31,Liberty,28,3
401310720,2021,UNLV,24,Utah State,28,4
401309873,2021,Washington State,34,Stanford,31,3
401282110,2021,Tennessee,26,Ole Miss,31,5
401282826,2021,Wisconsin,20,Army,14,6
401309874,2021,Washington,17,UCLA,24,7
401310718,2021,Boise State,17,Air Force,24,7
401309623,2021,App State,30,Coastal Carolina,27,3
401309624,2021,Arkansas State,27,Louisiana,28,1
401310729,2021,UNLV,20,San José State,27,7
401310725,2021,Utah State,26,Colorado State,24,2
401309877,2021,Arizona,16,Washington,21,5
401287928,2021,Texas Tech,24,Kansas State,25,1
401282717,2021,Penn State,18,Illinois,20,2
401301027,2021,Navy,20,Cincinnati,27,7
401309577,2021,Central Michigan,38,Northern Illinois,39,1
401282668,2021,Virginia Tech,36,Syracuse,41,5
401309576,2021,Ohio,27,Kent State,34,7
401282238,2021,UAB,24,Rice,30,6
401287925,2021,Iowa State,24,Oklahoma State,21,3
401309879,2021,UCLA,31,Oregon,34,3
401309881,2021,Washington State,19,BYU,21,2
401308838,2021,Ball State,17,Miami (OH),24,7
401301028,2021,Houston,31,East Carolina,24,7
401310727,2021,Fresno State,34,Nevada,32,2
401310724,2021,Air Force,14,San Diego State,20,6
401282665,2021,Miami,31,NC State,30,1
401309880,2021,Oregon State,42,Utah,34,8
401282667,2021,Virginia,48,Georgia Tech,40,8
401309627,2021,Coastal Carolina,35,Troy,28,7
401301030,2021,Tulsa,17,Navy,20,3
401282719,2021,Illinois,14,Rutgers,20,6
401282777,2021,Michigan State,37,Michigan,33,4
401287929,2021,Baylor,31,Texas,24,7
401282674,2021,Pittsburgh,34,Miami,38,4
401282726,2021,Maryland,38,Indiana,35,3
401282246,2021,Rice,24,North Texas,30,6
401287933,2021,West Virginia,38,Iowa State,31,7
401282801,2021,Nebraska,23,Purdue,28,5
401282244,2021,Old Dominion,23,Louisiana Tech,20,3
401310732,2021,San José State,27,Wyoming,21,6
401282243,2021,Florida Atlantic,28,UTEP,25,3
401309630,2021,Georgia Southern,14,Georgia State,21,7
401309886,2021,USC,41,Arizona,34,7
401301034,2021,Houston,44,SMU,37,7
401309883,2021,Stanford,13,Washington,20,7
401309579,2021,Akron,25,Ball State,31,6
401308839,2021,Ohio,35,Miami (OH),33,2
401309580,2021,Toledo,49,Eastern Michigan,52,3
401309582,2021,Kent State,52,Northern Illinois,47,5
401309632,2021,Louisiana,21,Georgia State,17,4
401310253,2021,Air Force,14,Army,21,7
401301039,2021,Memphis,28,SMU,25,3
401282720,2021,Minnesota,6,Illinois,14,8
401282682,2021,North Carolina,58,Wake Forest,55,3
401282681,2021,Miami,33,Georgia Tech,30,3
401309635,2021,Texas State,27,UL Monroe,19,8
401309889,2021,Arizona,10,California,3,7
401282247,2021,Charlotte,31,Rice,24,7
401309636,2021,Troy,31,South Alabama,24,7
401301037,2021,Cincinnati,28,Tulsa,20,8
401287936,2021,TCU,30,Baylor,28,2
401282121,2021,Arkansas,31,Mississippi State,28,3
401301036,2021,UCF,14,Tulane,10,4
401309891,2021,Colorado,37,Oregon State,34,3
401282120,2021,Alabama,20,LSU,14,6
401282123,2021,Kentucky,42,Tennessee,45,3
401282757,2021,Northwestern,12,Iowa,17,5
401282680,2021,Louisville,24,Clemson,30,6
401310740,2021,Nevada,27,San José State,24,3
401310739,2021,Hawai'i,10,San Diego State,17,7
401309584,2021,Western Michigan,45,Akron,40,5
401309583,2021,Eastern Michigan,26,Ohio,34,8
401309587,2021,Northern Illinois,30,Ball State,29,1
401282683,2021,Pittsburgh,30,North Carolina,23,7
401301042,2021,Memphis,29,East Carolina,30,1
401282780,2021,Penn State,17,Michigan,21,4
401309639,2021,Coastal Carolina,40,Georgia State,42,2
401309640,2021,Texas State,30,Georgia Southern,38,8
401282685,2021,Florida State,31,Miami,28,3
401282257,2021,Marshall,14,UAB,21,7
401282762,2021,Iowa,27,Minnesota,22,5
401287942,2021,Texas Tech,41,Iowa State,38,3
401282132,2021,Missouri,31,South Carolina,28,3
401301044,2021,Tulane,13,Tulsa,20,7
401282258,2021,North Texas,20,UTEP,17,3
401309638,2021,UL Monroe,24,Arkansas State,27,3
401309897,2021,Washington,30,Arizona State,35,5
401282130,2021,LSU,13,Arkansas,16,3
401287941,2021,Texas,56,Kansas,57,1
401282690,2021,Wake Forest,45,NC State,42,3
401310746,2021,San Diego State,23,Nevada,21,2
401309588,2021,Eastern Michigan,22,Western Michigan,21,1
401309590,2021,Buffalo,27,Northern Illinois,33,6
401310747,2021,Nevada,39,Air Force,41,2
401310751,2021,UNLV,20,San Diego State,28,8
401287944,2021,Oklahoma,28,Iowa State,21,7
401287947,2021,West Virginia,31,Texas,23,8
401282692,2021,Boston College,23,Florida State,26,3
401309643,2021,Georgia State,28,Arkansas State,20,8
401309903,2021,Colorado,20,Washington,17,3
401282265,2021,Middle Tennessee,17,Old Dominion,24,7
401282803,2021,Wisconsin,35,Nebraska,28,7
401282135,2021,Alabama,42,Arkansas,35,7
401282267,2021,UTSA,34,UAB,31,3
401301047,2021,Navy,35,East Carolina,38,3
401282141,2021,Missouri,24,Florida,23,1
401287945,2021,TCU,31,Kansas,28,3
401282142,2021,South Carolina,21,Auburn,17,4
401310749,2021,Hawai'i,50,Colorado State,45,5
401287952,2021,Texas,22,Kansas State,17,5
401282761,2021,Nebraska,21,Iowa,28,7
401301050,2021,UCF,17,South Florida,13,4
401309648,2021,South Alabama,21,Coastal Carolina,27,6
401282699,2021,NC State,34,North Carolina,30,4
401308842,2021,Kent State,48,Miami (OH),47,1
401282147,2021,Florida,24,Florida State,21,3
401287948,2021,Baylor,27,Texas Tech,24,3
401282271,2021,Rice,35,Louisiana Tech,31,4
401309647,2021,Arkansas State,22,Texas State,24,2
401282785,2021,Michigan State,30,Penn State,27,3
401282146,2021,Auburn,22,Alabama,24,2
401282703,2021,Virginia,24,Virginia Tech,29,5
401309650,2021,Louisiana,21,UL Monroe,16,5
401301055,2021,SMU,31,Tulsa,34,3
401282150,2021,LSU,27,Texas A&M,24,3
401287950,2021,Kansas,28,West Virginia,34,6
401287951,2021,Oklahoma State,37,Oklahoma,33,4
401301053,2021,Memphis,33,Tulane,28,5
401309910,2021,USC,31,BYU,35,4
401282156,2021,UTSA,49,Western Kentucky,41,8
401287953,2021,Oklahoma State,16,Baylor,21,5
401331161,2021,Louisiana,24,App State,16,8
401301056,2021,Army,13,Navy,17,4
401331164,2021,Toledo,24,Middle Tennessee,31,7
401331165,2021,Coastal Carolina,47,Northern Illinois,41,6
401331167,2021,Fresno State,31,UTEP,24,7
401331168,2021,BYU,28,UAB,31,3
401331215,2021,Army,24,Missouri,22,2
401331221,2021,Auburn,13,Houston,17,4
401331222,2021,Louisville,28,Air Force,31,3
401331227,2021,Iowa State,13,Clemson,20,7
401331230,2021,Purdue,48,Tennessee,45,3
401331232,2021,Arizona State,13,Wisconsin,20,7
401331654,2021,Central Michigan,24,Washington State,21,3
401331238,2021,Notre Dame,35,Oklahoma State,37,2
401331237,2021,Kentucky,20,Iowa,17,3
401331239,2021,Ohio State,48,Utah,45,3
401405059,2022,Northwestern,31,Nebraska,28,3
401416568,2022,Akron,30,St. Francis (PA),23,7
401426533,2022,Florida International,38,Bryant,37,1
401411092,2022,Pittsburgh,38,West Virginia,31,7
401416592,2022,Northern Illinois,34,Eastern Illinois,27,7
401405064,2022,Purdue,31,Penn State,35,4
401415213,2022,San José State,21,Portland State,17,4
401426330,2022,Old Dominion,20,Virginia Tech,17,3
401416590,2022,Eastern Michigan,42,Eastern Kentucky,34,8
401405061,2022,Indiana,23,Illinois,20,3
401411095,2022,App State,61,North Carolina,63,2
401405062,2022,Iowa,7,South Dakota State,3,4
401415611,2022,Navy,7,Delaware,14,7
401405069,2022,Boston College,21,Rutgers,22,1
401411096,2022,East Carolina,20,NC State,21,1
401415211,2022,Wyoming,40,Tulsa,37,3
401403855,2022,Arkansas,31,Cincinnati,24,7
401426542,2022,UTSA,35,Houston,37,2
401426536,2022,Ohio,41,Florida Atlantic,38,3
401404157,2022,Southern Miss,27,Liberty,29,2
401403857,2022,Florida,29,Utah,26,3
401403974,2022,Washington State,24,Idaho,17,7
401403867,2022,Florida State,24,LSU,23,1
401415613,2022,UCF,14,Louisville,20,6
401426553,2022,Army,38,UTSA,41,3
401403868,2022,Texas,19,Alabama,20,1
401405073,2022,Northwestern,23,Duke,31,8
401411103,2022,Georgia State,28,North Carolina,35,7
401416594,2022,Ball State,30,Western Michigan,37,7
401404125,2022,Notre Dame,21,Marshall,26,5
401403984,2022,Wisconsin,14,Washington State,17,3
401403877,2022,Pittsburgh,27,Tennessee,34,7
401403878,2022,Texas A&M,14,App State,17,3
401416595,2022,Bowling Green,57,Eastern Kentucky,59,2
401404064,2022,Iowa,7,Iowa State,10,3
401403976,2022,California,20,UNLV,14,6
401404063,2022,Texas Tech,33,Houston,30,3
401426551,2022,Liberty,21,UAB,14,7
401416596,2022,Buffalo,31,Holy Cross,37,6
401426332,2022,Coastal Carolina,31,Gardner-Webb,27,4
401415620,2022,Tulsa,38,Northern Illinois,35,3
401405072,2022,Nebraska,42,Georgia Southern,45,3
401403870,2022,Auburn,24,San José State,16,8
401426552,2022,UTEP,20,New Mexico State,13,7
401404062,2022,BYU,26,Baylor,20,6
401403979,2022,Fresno State,32,Oregon State,35,3
401411109,2022,Louisville,31,Florida State,35,4
401415217,2022,Wyoming,17,Air Force,14,3
401405084,2022,Syracuse,32,Purdue,29,3
401405083,2022,Northwestern,24,Southern Illinois,31,7
401426563,2022,Indiana,33,Western Kentucky,30,3
401405089,2022,Temple,14,Rutgers,16,2
401411113,2022,Virginia,16,Old Dominion,14,2
401403991,2022,UCLA,32,South Alabama,31,1
401403987,2022,Notre Dame,24,California,17,7
401404074,2022,Kansas State,10,Tulane,17,7
401426333,2022,App State,32,Troy,28,4
401415029,2022,Bowling Green,34,Marshall,31,3
401404159,2022,Wake Forest,37,Liberty,36,1
401426554,2022,Georgia State,41,Charlotte,42,1
401405087,2022,Maryland,34,SMU,27,7
401403883,2022,Florida,31,South Florida,28,3
401403890,2022,Texas A&M,17,Miami,9,8
401403985,2022,Arizona,31,North Dakota State,28,3
401411117,2022,Syracuse,22,Virginia,20,2
401404079,2022,Kansas,35,Duke,27,8
401403894,2022,Auburn,17,Missouri,14,3
401404080,2022,Iowa State,24,Baylor,31,7
401405097,2022,Michigan,34,Maryland,27,7
401411123,2022,Wake Forest,45,Clemson,51,6
401404078,2022,SMU,34,TCU,42,8
401416606,2022,Ohio,59,Fordham,52,7
401415224,2022,San Diego State,17,Toledo,14,3
401404082,2022,Texas Tech,37,Texas,34,3
401403901,2022,Tennessee,38,Florida,33,5
401415037,2022,App State,28,James Madison,32,4
401403999,2022,Washington State,41,Oregon,44,3
401403898,2022,Ole Miss,35,Tulsa,27,8
401415624,2022,East Carolina,20,Navy,23,3
401426570,2022,Houston,34,Rice,27,7
401426335,2022,Old Dominion,29,Arkansas State,26,3
401403896,2022,Kentucky,31,Northern Illinois,23,8
401403893,2022,Texas A&M,23,Arkansas,21,2
401415040,2022,Tulane,24,Southern Miss,27,3
401426566,2022,Purdue,28,Florida Atlantic,26,2
401405093,2022,Northwestern,14,Miami (OH),17,3
401426336,2022,UL Monroe,21,Louisiana,17,4
401404081,2022,Oklahoma,34,Kansas State,41,7
401404000,2022,Oregon State,14,USC,17,3
401415625,2022,Houston,24,Tulane,27,3
401404007,2022,UCLA,40,Washington,32,8
401415227,2022,Air Force,13,Navy,10,3
401411124,2022,Boston College,34,Louisville,33,1
401403905,2022,Ole Miss,22,Kentucky,19,3
401416608,2022,Ball State,44,Northern Illinois,38,6
401414782,2022,Eastern Michigan,20,Massachusetts,13,7
401416609,2022,Akron,28,Bowling Green,31,3
401404084,2022,Kansas,14,Iowa State,11,3
401416610,2022,Buffalo,24,Miami (OH),20,4
401404151,2022,UConn,19,Fresno State,14,5
401416611,2022,Kent State,31,Ohio,24,7
401426341,2022,Louisiana,17,South Alabama,20,3
401426573,2022,Charlotte,35,UTEP,41,6
401426578,2022,Western Kentucky,27,Troy,34,7
401426337,2022,Coastal Carolina,34,Georgia Southern,30,4
401403903,2022,Auburn,17,LSU,21,4
401403907,2022,Missouri,22,Georgia,26,4
401426577,2022,Rice,28,UAB,24,4
401411129,2022,Pittsburgh,21,Georgia Tech,26,5
401405111,2022,Rutgers,13,Nebraska,14,1
401415630,2022,Memphis,32,Houston,33,1
401415233,2022,Nevada,14,Colorado State,17,3
401404089,2022,Kansas,31,TCU,38,7
401405109,2022,Maryland,29,Purdue,31,2
401403910,2022,Florida,24,Missouri,17,7
401426342,2022,Georgia State,41,Georgia Southern,33,8
401415633,2022,Cincinnati,28,South Florida,24,4
401416613,2022,Central Michigan,16,Ball State,17,1
401416618,2022,Miami (OH),27,Kent State,24,3
401404009,2022,Arizona State,45,Washington,38,7
401411133,2022,Miami,24,North Carolina,27,3
401411132,2022,Georgia Tech,23,Duke,20,3
401426582,2022,UTSA,31,Western Kentucky,28,3
401415231,2022,Utah State,34,Air Force,27,7
401405106,2022,Illinois,9,Iowa,6,3
401404088,2022,Iowa State,9,Kansas State,10,1
401404127,2022,Notre Dame,28,BYU,20,8
401426344,2022,UL Monroe,21,Coastal Carolina,28,7
401403909,2022,Alabama,24,Texas A&M,20,4
401411134,2022,NC State,19,Florida State,17,2
401415235,2022,San Diego State,16,Hawai'i,14,2
401404010,2022,Stanford,27,Oregon State,28,1
401404092,2022,West Virginia,43,Baylor,40,3
401415635,2022,SMU,40,Navy,34,6
401416619,2022,Akron,21,Central Michigan,28,7
401416622,2022,Bowling Green,17,Miami (OH),13,4
401404093,2022,Texas,24,Iowa State,21,3
401411140,2022,Virginia Tech,14,Miami,20,6
401404153,2022,Ball State,25,UConn,21,4
401404014,2022,Colorado,20,California,13,7
401405114,2022,Indiana,33,Maryland,38,5
401404162,2022,Liberty,21,Gardner-Webb,20,1
401426352,2022,Troy,17,Texas State,14,3
401404095,2022,TCU,43,Oklahoma State,40,3
401403921,2022,Tennessee,52,Alabama,49,3
401405116,2022,Michigan State,34,Wisconsin,28,6
401426349,2022,Georgia Southern,45,James Madison,38,7
401426585,2022,Florida Atlantic,17,Rice,14,3
401426351,2022,Southern Miss,20,Arkansas State,19,1
401426350,2022,South Alabama,41,UL Monroe,34,7
401415238,2022,Colorado State,13,Utah State,17,4
401404016,2022,Notre Dame,14,Stanford,16,2
401411138,2022,Florida State,28,Clemson,34,6
401405113,2022,Purdue,43,Nebraska,37,6
401415637,2022,East Carolina,47,Memphis,45,2
401404017,2022,Utah,43,USC,42,1
401411137,2022,Duke,35,North Carolina,38,3
401415239,2022,Fresno State,17,San José State,10,7
401426354,2022,South Alabama,6,Troy,10,4
401411141,2022,Georgia Tech,9,Virginia,16,7
401426592,2022,Western Kentucky,20,UAB,17,3
401405121,2022,Rutgers,24,Indiana,17,7
401415641,2022,SMU,27,Cincinnati,29,2
401411142,2022,Clemson,27,Syracuse,21,6
401416628,2022,Kent State,33,Akron,27,6
401416626,2022,Buffalo,34,Toledo,27,7
401416625,2022,Ohio,24,Northern Illinois,17,7
401416624,2022,Ball State,16,Eastern Michigan,20,4
401426590,2022,Louisiana Tech,41,Rice,42,1
401416627,2022,Miami (OH),10,Western Michigan,16,6
401404098,2022,Oklahoma State,41,Texas,34,7
401426591,2022,UTSA,31,North Texas,27,4
401405118,2022,Maryland,31,Northwestern,24,7
401426356,2022,Old Dominion,23,Georgia Southern,28,5
401415242,2022,Colorado State,17,Hawai'i,13,4
401426589,2022,UTEP,24,Florida Atlantic,21,3
401404018,2022,Stanford,15,Arizona State,14,1
401403924,2022,Missouri,17,Vanderbilt,14,3
401426358,2022,Texas State,14,Southern Miss,20,6
401415241,2022,Air Force,14,Boise State,19,5
401403925,2022,South Carolina,30,Texas A&M,24,6
401404019,2022,California,21,Washington,28,7
401411146,2022,NC State,22,Virginia Tech,21,1
401404026,2022,Washington State,17,Utah,21,4
401415645,2022,BYU,24,East Carolina,27,3
401426594,2022,Florida International,42,Louisiana Tech,34,8
401416630,2022,Eastern Michigan,24,Toledo,27,3
401411150,2022,Virginia,12,Miami,14,2
401415646,2022,Navy,27,Temple,20,7
401415644,2022,UCF,25,Cincinnati,21,4
401426595,2022,Florida Atlantic,24,UAB,17,7
401404022,2022,Arizona,37,USC,45,8
401404023,2022,Colorado,34,Arizona State,42,8
401403931,2022,Texas A&M,28,Ole Miss,31,3
401415248,2022,Fresno State,32,San Diego State,28,4
401415249,2022,San José State,35,Nevada,28,7
401415247,2022,Hawai'i,20,Wyoming,27,7
401416632,2022,Kent State,20,Ball State,27,7
401416635,2022,Bowling Green,13,Western Michigan,9,4
401426601,2022,Rice,37,UTEP,30,7
401426364,2022,Coastal Carolina,35,App State,28,7
401411151,2022,Boston College,31,Duke,38,7
401404031,2022,Washington,24,Oregon State,21,3
401404141,2022,Army,7,Air Force,13,6
401403936,2022,Missouri,17,Kentucky,21,4
401411156,2022,Virginia,28,North Carolina,31,3
401405128,2022,Nebraska,13,Minnesota,20,7
401411157,2022,Virginia Tech,27,Georgia Tech,28,1
401404104,2022,Oklahoma,35,Baylor,38,3
401426602,2022,UAB,38,UTSA,44,6
401405127,2022,Illinois,15,Michigan State,23,8
401415651,2022,Memphis,28,UCF,35,7
401403932,2022,Arkansas,19,Liberty,21,2
401426365,2022,Georgia Southern,31,South Alabama,38,7
401426367,2022,Louisiana,17,Troy,23,6
401426368,2022,UL Monroe,31,Texas State,30,1
401415250,2022,Boise State,28,BYU,31,3
401403934,2022,LSU,32,Alabama,31,1
401415254,2022,San Diego State,14,UNLV,10,4
401404107,2022,Kansas State,27,Texas,34,7
401403935,2022,Mississippi State,39,Auburn,33,6
401404029,2022,USC,41,California,35,6
401416637,2022,Akron,28,Eastern Michigan,34,6
401416636,2022,Toledo,28,Ball State,21,7
401416639,2022,Western Michigan,21,Northern Illinois,24,3
401416640,2022,Central Michigan,31,Buffalo,27,4
401415654,2022,Cincinnati,27,East Carolina,25,2
401415259,2022,UNLV,30,Fresno State,37,7
401404112,2022,West Virginia,23,Oklahoma,20,3
401403942,2022,Kentucky,21,Vanderbilt,24,3
401405134,2022,Illinois,24,Purdue,31,7
401404131,2022,Navy,32,Notre Dame,35,3
401404156,2022,UConn,36,Liberty,33,3
401405138,2022,Michigan State,27,Rutgers,21,6
401403939,2022,Arkansas,10,LSU,13,3
401426372,2022,Georgia State,28,UL Monroe,31,3
401414784,2022,Arkansas State,35,Massachusetts,33,2
401415655,2022,Houston,43,Temple,36,7
401426373,2022,Marshall,28,App State,21,7
401404142,2022,Troy,10,Army,9,1
401411161,2022,NC State,20,Boston College,21,1
401404110,2022,Oklahoma State,20,Iowa State,14,6
401403943,2022,Ole Miss,24,Alabama,30,6
401415657,2022,Tulane,31,UCF,38,7
401404037,2022,Oregon,34,Washington,37,3
401415258,2022,Colorado State,13,Wyoming,14,1
401404113,2022,Texas,10,TCU,17,7
401426371,2022,Coastal Carolina,26,Southern Miss,23,3
401411164,2022,Wake Forest,34,North Carolina,36,2
401403940,2022,Auburn,13,Texas A&M,10,3
401404034,2022,UCLA,28,Arizona,34,6
401415257,2022,Hawai'i,34,Utah State,41,7
401416642,2022,Toledo,35,Bowling Green,42,7
401416644,2022,Kent State,24,Eastern Michigan,31,7
401416646,2022,Northern Illinois,23,Miami (OH),29,6
401416645,2022,Central Michigan,10,Western Michigan,12,2
401415659,2022,Tulsa,48,South Florida,42,6
401415661,2022,UCF,14,Navy,17,3
401411169,2022,Pittsburgh,28,Duke,26,2
401404165,2022,Liberty,22,Virginia Tech,23,1
401405143,2022,Purdue,17,Northwestern,9,8
401405142,2022,Nebraska,14,Wisconsin,15,1
401405146,2022,Michigan State,31,Indiana,39,8
401405145,2022,Michigan,19,Illinois,17,2
401404114,2022,Baylor,28,TCU,29,1
401403955,2022,Vanderbilt,31,Florida,24,7
401426378,2022,James Madison,42,Georgia State,40,2
401426608,2022,Charlotte,26,Louisiana Tech,21,5
401426379,2022,Southern Miss,20,South Alabama,27,7
401405141,2022,Minnesota,10,Iowa,13,3
401426380,2022,Texas State,16,Arkansas State,13,3
401411168,2022,North Carolina,17,Georgia Tech,21,4
401404041,2022,California,27,Stanford,20,7
401415261,2022,Wyoming,17,Boise State,20,3
401404115,2022,Iowa State,10,Texas Tech,14,4
401404044,2022,UCLA,45,USC,48,3
401415265,2022,Utah State,35,San José State,31,4
401404043,2022,Oregon,20,Utah,17,3
401415266,2022,Hawai'i,31,UNLV,25,6
401416648,2022,Miami (OH),18,Ball State,17,1
401403956,2022,Ole Miss,22,Mississippi State,24,2
401415665,2022,Cincinnati,24,Tulane,27,3
401416651,2022,Western Michigan,20,Toledo,14,6
401404045,2022,Arizona,38,Arizona State,35,3
401403961,2022,Missouri,29,Arkansas,27,2
401411172,2022,North Carolina,27,NC State,30,3
401405148,2022,Iowa,17,Nebraska,24,7
401404046,2022,California,28,UCLA,35,7
401403958,2022,Florida State,45,Florida,38,7
401403962,2022,Clemson,30,South Carolina,31,1
401426615,2022,Florida Atlantic,31,Western Kentucky,32,1
401426390,2022,Marshall,28,Georgia State,23,5
401426389,2022,South Alabama,27,Old Dominion,20,7
401404123,2022,Oklahoma State,19,West Virginia,24,5
401415664,2022,Temple,46,East Carolina,49,3
401416653,2022,Buffalo,27,Kent State,30,3
401426617,2022,North Texas,21,Rice,17,4
401404047,2022,Oregon State,38,Oregon,34,4
401426618,2022,UTSA,34,UTEP,31,3
401415666,2022,SMU,34,Memphis,31,3
401411174,2022,Duke,34,Wake Forest,31,3
401405150,2022,Wisconsin,16,Minnesota,23,7
401415272,2022,UNLV,27,Nevada,22,5
401426614,2022,Florida International,28,Middle Tennessee,33,5
401426382,2022,Georgia Southern,51,App State,48,3
401415667,2022,South Florida,39,UCF,46,7
401404122,2022,Texas Tech,51,Oklahoma,48,3
401415668,2022,Houston,30,Tulsa,37,7
401506450,2022,Buffalo,23,Akron,22,1
401437030,2022,TCU,28,Kansas State,31,3
401404145,2022,Army,20,Navy,17,3
401441993,2022,UAB,24,Miami (OH),20,4
401441994,2022,Troy,18,UTSA,12,6
401441997,2022,BYU,24,SMU,23,1
401442001,2022,Boise State,35,North Texas,32,3
401442006,2022,Toledo,21,Liberty,19,2
401442042,2022,Houston,23,Louisiana,16,7
401442009,2022,San Diego State,23,Middle Tennessee,25,2
401442037,2022,Bowling Green,19,New Mexico State,24,5
401441998,2022,Buffalo,23,Georgia Southern,21,2
401442005,2022,Oklahoma State,17,Wisconsin,24,7
401442030,2022,Arkansas,55,Kansas,53,2
401470891,2022,North Carolina,27,Oregon,28,1
401442032,2022,Minnesota,28,Syracuse,20,8
401442033,2022,Florida State,35,Oklahoma,32,3
401442034,2022,Washington,27,Texas,20,7
401442035,2022,NC State,12,Maryland,16,4
401443542,2022,UCLA,35,Pittsburgh,37,2
401442036,2022,South Carolina,38,Notre Dame,45,7
401443543,2022,Wyoming,27,Ohio,30,3
401442016,2022,Michigan,45,TCU,51,6
401442015,2022,Georgia,42,Ohio State,41,1
401442013,2022,USC,45,Tulane,46,1
401520145,2023,Jacksonville State,17,UTEP,14,3
401532392,2023,San Diego State,20,Ohio,13,7
401520147,2023,Vanderbilt,35,Hawai'i,28,7
401520146,2023,Louisiana Tech,22,Florida International,17,5
401531834,2023,Georgia State,42,Rhode Island,35,7
401520148,2023,Minnesota,13,Nebraska,10,3
401523987,2023,Arizona State,24,Southern Utah,21,3
401525462,2023,Georgia Tech,34,Louisville,39,5
401525464,2023,Boston College,24,Northern Illinois,27,3
401523994,2023,TCU,42,Colorado,45,3
401520170,2023,Purdue,35,Fresno State,39,4
401531387,2023,Temple,24,Akron,21,3
401531838,2023,Marshall,21,UAlbany,17,4
401520153,2023,Florida International,14,Maine,12,2
401525819,2023,Houston,17,UTSA,14,3
401520175,2023,UL Monroe,17,Army,13,4
401520155,2023,Illinois,30,Toledo,28,2
401525825,2023,Wyoming,35,Texas Tech,33,2
401532571,2023,San Diego State,36,Idaho State,28,8
401525490,2023,Boston College,31,Holy Cross,28,3
401525498,2023,Virginia,35,James Madison,36,1
401520215,2023,Virginia Tech,17,Purdue,24,7
401523999,2023,Baylor,13,Utah,20,7
401532396,2023,Central Michigan,45,New Hampshire,42,3
401532397,2023,Northern Illinois,11,Southern Illinois,14,3
401531395,2023,UTSA,20,Texas State,13,7
401520194,2023,Iowa State,13,Iowa,20,7
401525495,2023,North Carolina,40,App State,34,6
401531842,2023,Old Dominion,38,Louisiana,31,7
401531419,2023,Florida Atlantic,10,Ohio,17,7
401532401,2023,Buffalo,37,Fordham,40,3
401532399,2023,Akron,24,Morgan State,21,3
401520189,2023,Florida International,46,North Texas,39,7
401525496,2023,Pittsburgh,21,Cincinnati,27,6
401525831,2023,Rice,43,Houston,41,2
401524002,2023,Texas Tech,30,Oregon,38,8
401525827,2023,Boise State,16,UCF,18,2
401520206,2023,Missouri,23,Middle Tennessee,19,4
401520205,2023,Mississippi State,31,Arizona,24,7
401532574,2023,Fresno State,34,Eastern Washington,31,3
401520186,2023,California,10,Auburn,14,4
401531428,2023,Memphis,28,Navy,24,4
401531396,2023,UTSA,29,Army,37,8
401520230,2023,Indiana,14,Louisville,21,7
401525500,2023,Boston College,29,Florida State,31,2
401525838,2023,Ohio,10,Iowa State,7,3
401525504,2023,Old Dominion,24,Wake Forest,27,3
401520236,2023,Missouri,30,Kansas State,27,3
401526834,2023,Eastern Michigan,19,Massachusetts,17,2
401520246,2023,UConn,17,Florida International,24,7
401520229,2023,Louisiana Tech,37,North Texas,40,3
401520247,2023,UNLV,40,Vanderbilt,37,3
401525835,2023,Cincinnati,24,Miami (OH),31,7
401532403,2023,Toledo,21,San José State,17,4
401531848,2023,Troy,14,James Madison,16,2
401520220,2023,Arkansas,31,BYU,38,7
401524010,2023,Stanford,23,Sacramento State,30,7
401524007,2023,Colorado,43,Colorado State,35,8
401525837,2023,Nevada,24,Kansas,31,7
401525505,2023,Virginia,21,NC State,24,3
401532583,2023,San Diego State,31,Boise State,34,3
401525507,2023,Clemson,24,Florida State,31,7
401525511,2023,Marshall,24,Virginia Tech,17,7
401520271,2023,Troy,27,Western Kentucky,24,3
401531338,2023,Northern Illinois,14,Tulsa,22,8
401525850,2023,West Virginia,20,Texas Tech,13,7
401531873,2023,Old Dominion,10,East Texas A&M,9,1
401526835,2023,Massachusetts,31,New Mexico,34,3
401520255,2023,Illinois,23,Florida Atlantic,17,6
401524017,2023,Utah,14,UCLA,7,7
401525846,2023,Iowa State,34,Oklahoma State,27,7
401531876,2023,South Alabama,30,Central Michigan,34,4
401524016,2023,Stanford,20,Arizona,21,1
401531874,2023,Arkansas State,44,Southern Miss,37,7
401524019,2023,Washington State,38,Oregon State,35,3
401520258,2023,LSU,34,Arkansas,31,3
401531870,2023,Wyoming,22,App State,19,3
401520262,2023,Middle Tennessee,23,Colorado State,31,8
401520259,2023,Missouri,34,Memphis,27,7
401520256,2023,Indiana,29,Akron,27,2
401521330,2023,Notre Dame,14,Ohio State,17,3
401520267,2023,South Carolina,37,Mississippi State,30,7
401520264,2023,Northwestern,37,Minnesota,34,3
401531875,2023,Louisiana,45,Buffalo,38,7
401531872,2023,Utah State,38,James Madison,45,7
401520253,2023,Hawai'i,20,New Mexico State,17,3
401520276,2023,Sam Houston,28,Jacksonville State,35,7
401525512,2023,NC State,10,Louisville,13,3
401525851,2023,BYU,35,Cincinnati,27,8
401520292,2023,UConn,33,Utah State,34,1
401524023,2023,Colorado,41,USC,48,7
401531880,2023,James Madison,31,South Alabama,23,8
401532412,2023,Akron,10,Buffalo,13,3
401532410,2023,Central Michigan,26,Eastern Michigan,23,3
401525513,2023,Boston College,27,Virginia,24,3
401524022,2023,California,24,Arizona State,21,3
401531881,2023,Marshall,41,Old Dominion,35,6
401520280,2023,Auburn,20,Georgia,27,7
401532411,2023,Toledo,35,Northern Illinois,33,2
401525856,2023,UCF,35,Baylor,36,1
401531429,2023,Memphis,35,Boise State,32,3
401520288,2023,Ole Miss,55,LSU,49,6
401531414,2023,Rice,24,East Carolina,17,7
401525438,2023,Duke,14,Notre Dame,21,7
401531882,2023,UL Monroe,40,App State,41,1
401525853,2023,TCU,21,West Virginia,24,3
401524021,2023,Arizona,24,Washington,31,7
401520296,2023,Liberty,21,Sam Houston,16,5
401520295,2023,Louisiana Tech,28,Western Kentucky,35,7
401525857,2023,Oklahoma State,29,Kansas State,21,8
401525861,2023,Texas,30,Oklahoma,34,4
401520298,2023,Army,24,Boston College,27,3
401525521,2023,NC State,48,Marshall,41,7
401524028,2023,UCLA,25,Washington State,17,8
401520306,2023,Northwestern,23,Howard,20,3
401531433,2023,Navy,27,North Texas,24,3
401520302,2023,Iowa,20,Purdue,14,6
401525517,2023,Clemson,17,Wake Forest,12,5
401531884,2023,Louisiana,34,Texas State,30,4
401520310,2023,Texas A&M,20,Alabama,26,6
401520309,2023,Rice,31,UConn,38,7
401531340,2023,Florida Atlantic,20,Tulsa,17,3
401524026,2023,Arizona State,24,Colorado,27,3
401531886,2023,Southern Miss,13,Old Dominion,17,4
401520308,2023,Ole Miss,27,Arkansas,20,7
401532591,2023,Wyoming,24,Fresno State,19,5
401525519,2023,Miami,20,Georgia Tech,23,3
401532592,2023,Boise State,35,San José State,27,8
401524025,2023,USC,43,Arizona,41,2
401520313,2023,Middle Tennessee,31,Louisiana Tech,23,8
401531888,2023,App State,24,Coastal Carolina,27,3
401525862,2023,Houston,41,West Virginia,39,2
401532594,2023,Utah State,32,Fresno State,37,5
401524029,2023,Colorado,43,Stanford,46,3
401520324,2023,Rutgers,27,Michigan State,24,3
401520316,2023,Alabama,24,Arkansas,21,3
401532419,2023,Ball State,6,Toledo,13,7
401520326,2023,Tennessee,20,Texas A&M,13,7
401532420,2023,Central Michigan,17,Akron,10,7
401520325,2023,South Carolina,39,Florida,41,2
401524034,2023,Washington,36,Oregon,33,3
401525864,2023,Oklahoma State,39,Kansas,32,7
401520320,2023,Maryland,24,Illinois,27,3
401531891,2023,Texas State,21,UL Monroe,20,1
401532598,2023,Air Force,34,Wyoming,27,7
401532593,2023,Colorado State,31,Boise State,30,1
401532595,2023,Hawai'i,34,San Diego State,41,7
401520330,2023,Liberty,42,Middle Tennessee,35,7
401520329,2023,Jacksonville State,20,Western Kentucky,17,3
401520331,2023,Sam Houston,27,Florida International,33,6
401525871,2023,Oklahoma,31,UCF,29,2
401525868,2023,Cincinnati,29,Baylor,32,3
401532428,2023,Ohio,20,Western Michigan,17,3
401520334,2023,Arkansas,3,Mississippi State,7,4
401520343,2023,Ohio State,20,Penn State,12,8
401531406,2023,East Carolina,7,Charlotte,10,3
401520344,2023,UConn,21,South Florida,24,3
401532425,2023,Ball State,24,Central Michigan,17,7
401532426,2023,Northern Illinois,20,Eastern Michigan,13,7
401520338,2023,Iowa,10,Minnesota,12,2
401525532,2023,Wake Forest,21,Pittsburgh,17,4
401520336,2023,Illinois,21,Wisconsin,25,4
401520342,2023,Nebraska,17,Northwestern,9,8
401531372,2023,Tulane,35,North Texas,28,7
401525869,2023,Houston,24,Texas,31,7
401532427,2023,Miami (OH),17,Toledo,21,4
401525531,2023,North Carolina,27,Virginia,31,4
401532599,2023,UNLV,25,Colorado State,23,2
401520335,2023,Auburn,21,Ole Miss,28,7
401531895,2023,Old Dominion,28,App State,21,7
401531897,2023,Louisiana,17,Georgia State,20,3
401524037,2023,USC,32,Utah,34,2
401525529,2023,Miami,28,Clemson,20,8
401532601,2023,San Diego State,0,Nevada,6,6
401524038,2023,Washington,15,Arizona State,7,8
401520345,2023,Louisiana Tech,24,New Mexico State,27,3
401520348,2023,Sam Houston,34,UTEP,37,3
401520351,2023,Boston College,21,UConn,14,7
401525874,2023,Kansas,38,Oklahoma,33,5
401520349,2023,Army,14,Massachusetts,21,7
401520356,2023,Northwestern,33,Maryland,27,6
401525534,2023,NC State,24,Clemson,17,7
401531430,2023,North Texas,42,Memphis,45,3
401525538,2023,Miami,29,Virginia,26,3
401524041,2023,California,49,USC,50,1
401531373,2023,Rice,28,Tulane,30,2
401520353,2023,Kentucky,27,Tennessee,33,6
401525537,2023,Georgia Tech,46,North Carolina,42,4
401531900,2023,James Madison,30,Old Dominion,27,3
401524039,2023,Arizona,27,Oregon State,24,3
401532606,2023,Fresno State,31,UNLV,24,7
401532433,2023,Central Michigan,37,Northern Illinois,31,6
401532435,2023,Bowling Green,24,Ball State,21,3
401532436,2023,Akron,31,Kent State,27,4
401525879,2023,Texas Tech,35,TCU,28,7
401525539,2023,Duke,24,Wake Forest,21,3
401525540,2023,Syracuse,10,Boston College,17,7
401520374,2023,Ole Miss,38,Texas A&M,35,3
401525441,2023,Clemson,31,Notre Dame,23,8
401520369,2023,Michigan State,20,Nebraska,17,3
401520363,2023,Florida,36,Arkansas,39,3
401520365,2023,Indiana,20,Wisconsin,14,6
401525884,2023,Texas,33,Kansas State,30,3
401525451,2023,Sam Houston,24,Kennesaw State,21,3
401531383,2023,UAB,45,Florida Atlantic,42,3
401531399,2023,North Texas,29,UTSA,37,8
401531374,2023,East Carolina,10,Tulane,13,3
401531907,2023,Old Dominion,24,Coastal Carolina,28,4
401525881,2023,Cincinnati,26,UCF,28,2
401525880,2023,Baylor,24,Houston,25,1
401520373,2023,Northwestern,7,Iowa,10,3
401525883,2023,Oklahoma State,27,Oklahoma,24,3
401520370,2023,Minnesota,26,Illinois,27,1
401531343,2023,Tulsa,26,Charlotte,33,7
401520372,2023,New Mexico State,13,Middle Tennessee,7,6
401525882,2023,Iowa State,21,Kansas,28,7
401532612,2023,San Diego State,24,Utah State,32,8
401531440,2023,Rice,31,SMU,36,5
401520378,2023,UTEP,13,Western Kentucky,21,8
401524050,2023,Washington State,7,Stanford,10,3
401524046,2023,Colorado,19,Oregon State,26,7
401532608,2023,Fresno State,37,Boise State,30,7
401532437,2023,Northern Illinois,17,Ball State,20,3
401525546,2023,Louisville,31,Virginia,24,7
401531911,2023,Louisiana,31,Southern Miss,34,3
401520383,2023,Illinois,48,Indiana,45,3
401520381,2023,Army,17,Holy Cross,14,3
401531393,2023,South Florida,27,Temple,23,4
401531344,2023,Tulane,24,Tulsa,22,2
401525888,2023,Kansas,13,Texas Tech,16,3
401520392,2023,Nebraska,10,Maryland,13,3
401531408,2023,Charlotte,38,Memphis,44,6
401524052,2023,Colorado,31,Arizona,34,3
401524056,2023,Washington,35,Utah,28,7
401525550,2023,Florida State,27,Miami,20,7
401531912,2023,Coastal Carolina,31,Texas State,23,8
401524051,2023,California,42,Washington State,39,3
401531916,2023,South Alabama,21,Arkansas State,14,7
401532617,2023,Colorado State,22,San Diego State,19,3
401531914,2023,Marshall,38,Georgia Southern,33,5
401525891,2023,TCU,26,Texas,29,3
401525549,2023,North Carolina,47,Duke,45,2
401532445,2023,Eastern Michigan,30,Akron,27,3
401532443,2023,Bowling Green,31,Toledo,32,1
401525553,2023,Pittsburgh,24,Boston College,16,8
401520403,2023,Army,28,Coastal Carolina,21,7
401525558,2023,Miami,31,Louisville,38,7
401520405,2023,Indiana,21,Michigan State,24,3
401520410,2023,Maryland,24,Michigan,31,7
401520414,2023,Northwestern,23,Purdue,15,8
401525893,2023,BYU,24,Oklahoma,31,7
401531431,2023,Memphis,34,SMU,38,4
401531918,2023,James Madison,23,App State,26,3
401520411,2023,Middle Tennessee,34,UTEP,30,4
401525555,2023,Virginia,30,Duke,27,3
401531345,2023,Tulsa,28,North Texas,35,7
401531921,2023,Troy,31,Louisiana,24,7
401525559,2023,Virginia Tech,28,NC State,35,7
401520423,2023,Western Kentucky,28,Sam Houston,23,5
401532624,2023,Air Force,27,UNLV,31,4
401520406,2023,Iowa,15,Illinois,13,2
401525898,2023,Texas Tech,24,UCF,23,1
401531917,2023,Georgia Southern,17,Old Dominion,20,3
401525896,2023,Kansas,27,Kansas State,31,4
401524060,2023,Oregon State,20,Washington,22,2
401520413,2023,Missouri,33,Florida,31,2
401520422,2023,Wisconsin,24,Nebraska,17,7
401520418,2023,South Carolina,17,Kentucky,14,3
401532622,2023,Fresno State,17,New Mexico,25,8
401520425,2023,Nebraska,10,Iowa,13,3
401532629,2023,New Mexico,41,Utah State,44,3
401532625,2023,Boise State,27,Air Force,19,8
401532454,2023,Ball State,15,Miami (OH),17,2
401520432,2023,Louisville,31,Kentucky,38,7
401520434,2023,Michigan,30,Ohio State,24,6
401520438,2023,Purdue,35,Indiana,31,4
401520440,2023,Sam Houston,23,Middle Tennessee,20,3
401531421,2023,Rice,24,Florida Atlantic,21,3
401525563,2023,Syracuse,35,Wake Forest,31,4
401531925,2023,Old Dominion,25,Georgia State,24,1
401531386,2023,North Texas,45,UAB,42,3
401531346,2023,East Carolina,27,Tulsa,29,2
401524067,2023,Utah,23,Colorado,17,6
401532628,2023,UNLV,31,San José State,37,6
401520427,2023,Auburn,24,Alabama,27,3
401525905,2023,Oklahoma State,40,BYU,34,6
401520431,2023,Illinois,43,Northwestern,45,2
401520437,2023,New Mexico State,20,Jacksonville State,17,3
401524068,2023,Washington,24,Washington State,21,3
401525902,2023,Baylor,31,West Virginia,34,3
401531928,2023,Texas State,52,South Alabama,44,8
401520430,2023,Georgia Tech,23,Georgia,31,8
401525904,2023,Kansas State,35,Iowa State,42,7
401532626,2023,Hawai'i,27,Colorado State,24,3
401539475,2023,Washington,34,Oregon,31,3
401539483,2023,Alabama,27,Georgia,24,3
401520445,2023,Army,17,Navy,11,6
401551751,2023,Louisiana,31,Jacksonville State,34,3
401551731,2023,App State,13,Miami (OH),9,4
401551469,2023,Old Dominion,35,Western Kentucky,38,3
401551741,2023,Northern Illinois,21,Arkansas State,19,2
401551739,2023,Duke,17,Troy,10,7
401551744,2023,Northwestern,14,Utah,7,7
401551756,2023,Minnesota,30,Bowling Green,24,6
401551749,2023,Oklahoma State,31,Texas A&M,23,8
401551762,2023,Miami,24,Rutgers,31,7
401551766,2023,Kentucky,35,Clemson,38,3
401554566,2023,Wyoming,16,Toledo,15,1
401551778,2023,LSU,35,Wisconsin,31,4
401551786,2023,Michigan,27,Alabama,20,7
401551788,2023,Washington,37,Texas,31,6
